########################################
#...#.F.....#...............###......###
###.#######.#.#########.###.#...####...#
#.#.#.#...#.####........#...#.########.#
#.#.#.#.#.#....#.###.##.#.###.#......#.#
#.#...#.#.####.#...#..#.#.....#.####.#.#
#.###.#.#.#..#.###.##.#.#######.#....#.#
#.......#.##.#........#...#.....######.#
###.###.#....#.##.#######.#####........#
#.###.#.#.####..#.#.....#.....########.#
#............##.#.#.###.#.###.......#..#
#.###.#.###.##..#.#...#.#...#####.#.####
#.....#.#...#####.#####.#####...#.#...##
#####.#.#.###.#.#.......#...#.#.#.###.##
#.#.###.###.#.#.#.#.#####.#.#.#.#...#.##
#...........#.#.#.#.#...#.#.#.#.###.#.##
#.#...#.#.#...#.......#.#.#.#.#.....#.##
#.#.#.#.#.#.#.#########.#.#...######..##
#...#...#...#...........#.#####......#.#
###.#####################S#.#.###.#.##.#
#.........#.......................#....#
########################################